3 3
*******
*     *
*** * *
*   * *
* * * *
* *   *
*******