30 30
*************************************************************
*   *     *   *         * * *         *     * *   * *       *
* * ***** * * * *** * *** * * * ********* *** * *** *** *****
* *       * * * *   *   * *   *           *   *   *   *   * *
* *** * ***** * ***** * * ******* *** * * * *** * * * * * * *
*   * *     *     * * *     *   * * * * *     * *   *   * * *
* *** ********* *** * * ***** * *** ***** * ******* * *** * *
*   * *   * * * * *   *       * *   *   * *   *     *   * * *
* ***** *** * * * ***** *********** * * * * ********* ***** *
* * *   *   * * * *   * *   *   *   * *   * *   * *   * * * *
* * *** * * * * * *** *** * * ***** * ***** * * * *** * * * *
* * *   * *         *     * * *     *   * *   *       *     *
* * * *** *** * * *** * *** * ***** *** * * *********** * * *
* *       *   * *     * * *   *     *   *     *   *     * * *
* * * ******* ***** * *** ***** *** * * *** ***** ***** * ***
*   *     *   *     * * *       * *   *   *   *         *   *
* * ******* ******* *** * ******* *** ***** *** *** *** *** *
* *     * * *         *   *     *     * *     *   * * * *   *
*** ***** * * ********* *** *** * *** * * *** * ***** *** ***
*       * * * * * * * *   *   * * *   *     * * * *   *     *
********* * *** * * * ***** ********* * *** *** * *** *******
*         *   *       * *     * *     *   * * *   *   *     *
******* *** ***** * *** * ***** * *** ******* *** *** * *****
* *     *     *   *     * *       *       * * *   *         *
* ***** * * *** * *** *** *** ******* * *** * *** * * *** ***
* *       *   * * * *     *       *   * * *   *   * * *   * *
* *** *** * * ***** * * ***** * ********* *** * *** *** * * *
* * * *   * *     *   *       *   *         * *   * * * *   *
* * *** * ******* * ******* ***** ********* * * *** * * * ***
*       * * * *   * *   * * *     *   *   *         *   * * *
*** ******* * *** *** *** *** * ***** *** * *** *********** *
*       * *   * * * *   *   * * *       *   * * * *     * * *
* *** * * * *** * * * *** *** *** *** *** * * * * * *** * * *
*   * *   *       * * *     *     *     * * *     *   * * * *
********* * ******* * ***** * *** * * * * ******* *** * * * *
* *   *   *   * *       * *     * * * * * *   *   * * * *   *
* * *** ******* *** ***** *** *** *** ***** *** *** * * * * *
*           * *               *   *   * *       *   * *   * *
* ******* * * *** ******* *** *** * * * * * *** *** *** *****
*   * *   * * * *     * * *   * * * *   * *   *     *   *   *
* *** *** *** * * *** * ***** * *** * ***** ***** * * * *** *
* * *     *         *     *     *   *     *     * *   *     *
* * * ******* ***** * ***** * ***** *** *** *** *** *********
* *         * * *   *     * * * * * *         * * * * *     *
* *** *** * *** * *** * * ***** * *** * *** ***** *** ***** *
* *     * *       * * * *         *   * *   * *   * * * *   *
* ********* ******* * ******* ********* *** * *** * * * *** *
*       *   *     * *     * * *     *     * * *     * * * * *
* * ***** *** ***** ***** * ***** *** ***** * *** * * * * * *
* *   *   *   *   *           *         * * *     * *   *   *
*** *** * * ***** *********** ********* * * ***** ***** *** *
*   * * *     * * * * *   *   * *   *     * * * *           *
***** *** *** * * * * * *** * * * *** *** *** * * * *** *****
*   * *     * *           * *   *       *   *     *   * * * *
* *** * * ******* * ******* *** ******* ***** ***** * *** * *
* *     *   *   * *     *   *     * * * *   * * *   *     * *
* *** ******* *** * ***** *** *** * * * * * * * * ********* *
*   *       *     *         * *     *     *   *         *   *
* * * *** ***** * * * ***** *** ***** *** * * ********* *** *
* *   *     *   * * * *     *     *     * * *         *     *
*************************************************************